"Let me hear "win" on three, 1 2 3…"

"WIN!"

It's gameday again. You jog down the tunnel to the field with the coach's inspirational speech still ringing in your ears. By the time you emerge onto the field, the frenzied introductions of the offensive and defensive stars are over and the welcoming rows of cheerleaders have broken up. You quietly wend your way through the men disassembling the giant helmet that the other players got to burst through to the adoration of the crowd.

You head over to your team's sideline and stand inconspicuously near your practice equipment. One of the backup linebackers runs past and stops to smash his facemask into yours, screaming Gameday! It's on now! Wooooooo! but when he realises who you are he looks disappointed and walks away. You pretend to stretch your kicking leg.

Please press SPACE to continue.

Kicker
An Interactive Fiction by Pippin Barr
Release 1 / Serial number 130529 / Inform 7 build 6G60 (I6/v6.32 lib 6/12N) SD

The Sidelines
Ah yes, the sidelines. The place where you spend almost all of your time. The ground is a little muddy and the benches are almost vindictively uncomfortable, but it is what it is. There's a bunch of equipment around and as always it's crowded with teammates, coaches, and assorted others. To the west you can see the part of the stadium seating nearest you, and to the east you can see the field. The Jumbotron looms above it all.

Before you know it your team has won the coin toss and elected to kick off. That would be your job. Now would be a good time to run onto the field.

(If you need help during this game, try help or walkthrough.)

You can see the offensive unit, the defensive unit, the holder, the punter, the head coach, the special teams coach, some assistant coaches, a film crew, some cheerleaders and an equipment manager here.

>x game
Rather than watch the game, perhaps you should get into it.

Your coach nods to you and instructs you run onto the field.

>run on
You run onto the field.

The Field
You find yourself standing on the field of play at your own 30 yard line. Refreshingly, everyone is paying attention to you. The crowd looms all around you, largely silent as they wait for you to signal your kick. To the west you can see your home sidelines and to the east is the opposition sidelines. The Jumbotron looms above it all.

You can see the special teams unit, some officials and the opposition here.

The members of the kickoff team wait for you to give the signal.

>x game
(the game)
You see nothing special about the game.

Your teammates watch closely for your signal.

* * *

>tackle
Tackling someone right now would be incredibly impolite.

Q1, 15:00 : 1 & 0 @ 30 (1)
Home 0 - 0 Away 
Offence TOs: 3 - Defence TOs: 3 
PC: kickoff -> PR: kickoff -> FPR: kickoff return 
GYG: 0 -> NYG: 0 -> GYR: 18 -> NYR: 18 
KD: 66 -> GYR: 18 -> NYR: 18 

Clock is: stopped
The kickoff unit runs off the field.

The defense runs onto the field.

>tackle
You think about tackling someone, and then you don't do it.

Q1, 14:48 : 1 & 10 @ 22 (-1)
Home 0 - 0 Away 
Offence TOs: 3 - Defence TOs: 3 
PC: run -> PR: no gain -> FPR: no gain 
GYG: 0 -> NYG: 0 -> GYR: 18 -> NYR: 18 
KD: 66 -> GYR: 18 -> NYR: 18 

Clock is: running

>tackle
As amusing as tackling someone right now might be, it's just not a good idea.

Q1, 14:08 : 2 & 10 @ 22 (-1)
Home 0 - 0 Away 
Offence TOs: 3 - Defence TOs: 3 
PC: pass -> PR: incompletion -> FPR: false start 
GYG: 0 -> NYG: 0 -> GYR: 18 -> NYR: 18 
KD: 66 -> GYR: 18 -> NYR: 18 

Clock is: stopped
You hear the referee's voice announce a penalty..

>tackle
Tackling someone right now would be incredibly impolite.

Q1, 14:08 : 2 & 15 @ 17 (-1)
Home 0 - 0 Away 
Offence TOs: 3 - Defence TOs: 3 
PC: run -> PR: gain -> FPR: gain 
GYG: 2 -> NYG: 2 -> GYR: 18 -> NYR: 18 
KD: 66 -> GYR: 18 -> NYR: 18 

Clock is: running

>tackle
You imagine tackling someone instead, it's safer and better.

Q1, 13:31 : 3 & 13 @ 19 (-1)
Home 0 - 0 Away 
Offence TOs: 3 - Defence TOs: 3 
PC: pass -> PR: sack -> FPR: sack 
GYG: -2 -> NYG: -2 -> GYR: 18 -> NYR: 18 
KD: 66 -> GYR: 18 -> NYR: 18 

Clock is: running
The crowd cheers.

The defense runs off the field.

The punt return team runs onto the field.

>tackle
You look around you for a likely subject to tackle, but then think better of it.

Q1, 12:49 : 4 & 15 @ 17 (-1)
Home 0 - 0 Away 
Offence TOs: 3 - Defence TOs: 3 
PC: punt -> PR: punt -> FPR: punt 
GYG: 0 -> NYG: 0 -> GYR: 0 -> NYR: 0 
KD: 45 -> GYR: 0 -> NYR: 0 

Clock is: stopped
The punt return unit runs off the field.

The offense runs onto the field.

>tackle
As amusing as tackling someone right now might be, it's just not a good idea.

Q1, 12:39 : 1 & 10 @ 38 (1)
Home 0 - 0 Away 
Offence TOs: 3 - Defence TOs: 3 
PC: pass -> PR: sack -> FPR: sack 
GYG: -2 -> NYG: -2 -> GYR: 0 -> NYR: 0 
KD: 45 -> GYR: 0 -> NYR: 0 

Clock is: running
The crowd makes a wincing sound.

>tackle
Instead of tackling someone, you don't tackle anyone at all.

Q1, 12:03 : 2 & 12 @ 36 (1)
Home 0 - 0 Away 
Offence TOs: 3 - Defence TOs: 3 
PC: pass -> PR: incompletion -> FPR: incompletion 
GYG: 0 -> NYG: 0 -> GYR: 0 -> NYR: 0 
KD: 45 -> GYR: 0 -> NYR: 0 

Clock is: stopped

>make tackle
You think about tackling someone, and then you don't do it.

Q1, 11:55 : 3 & 12 @ 36 (1)
Home 0 - 0 Away 
Offence TOs: 3 - Defence TOs: 3 
PC: pass -> PR: gain -> FPR: gain 
GYG: 10 -> NYG: 10 -> GYR: 0 -> NYR: 0 
KD: 45 -> GYR: 0 -> NYR: 0 

Clock is: running
The offense runs off the field.

The punt team runs onto the field.

>tackle man
I only understood you as far as wanting to tackle.

* * *

>wear helmet
You put on your helmet.

O: 3, D: 3
The coach calls you over and tells you to get on the field.

>drop helmet
You consider throwing down your helmet in a fit of pique, but decide against it.

O: 3, D: 3
The coach grinds his teeth and tells you to get on the field.

>ru on
That's not a verb I recognise.

>run on
You hurry onto the field.

O: 3, D: 3
The members of the coverage unit waits for you to give the signal.

>l
The field
In The field you can see the special teams unit, an officials and the opposition.

O: 3, D: 3
Your teammates shift a little as they wait for your signal.

>remove helmet
The rulebook is pretty clear about not removing your helmet on the field of play.

O: 3, D: 3
The play clock has almost run down. You really need to give the signal right now.

* * *

>stretch
You do some brisk lunges and feel vaguely more like a professional athlete.

The coach waves at you to run onto the field.

>stretch
You ostentatiously perform a hamstring stretch, looking around to see if anyone's watching.

The coach screams at you to run onto the field.

>sigh
You sigh. It doesn't help your mood.

The coach yells that you better run on without delay.

>talk to yourself
You're already enough of an outcast on the team as it is.

Your coach has to burn a timeout because you delayed too long before getting out onto the field. He looks extremely displeased. He grabs you by the jersey and orders you to run onto the field.

>talk to crowd
You turn to stare into the seething mass of the crowd and can't think of anything to say.

The coach orders you to run onto the field.

>talk to crowd
You probably have better things to do than shouting at the crowd. Well, perhaps not, but it's not going to happen.

The coach yells hoarsely that you need to run onto the field.

>talk to film crew
It's generally considered impolite to talk on the sidelines with your helmet on.

The coach screams with a red face that you have to run on immediately.

>remove hlmet
You can't see any such thing.

>remove helmet
You take off your helmet.

The head coach quickly calls a timeout because you didn't even run onto the field to kick. He looks extraordinarily unimpressed. He suggests that perhaps this time you would do everyone a favour and run onto the field.

>talk to crew
You step toward the film crew to have a chat, but they're in the middle of filming a segment about your team's quarterback so you wander away.

The coach nods to you and instructs you run onto the field.

>talk to cheerleader
You clear your throat and try to impress the cheerleaders by telling them that you used to do ballet when you were a boy, but they just go on dancing and smiling their dazzling smiles at the crowd.

The coach grinds his teeth and tells you to run onto the field.

* * *

>talk to film crew
You try to casually have a word with the film crew, but they all shake their heads at you in unison and you stop.

Your coach waves at you to run onto the field.

>l quarterback
It cannot be denied: he's a good-looking guy.

Your coach yells hoarsely that you need to run onto the field.

>l quarterback
It cannot be denied: he's a good-looking guy.

Your coach roars in your face to run on immediately.

* * *

>l north
It's sidelines all the way along.

The coach orders you to run onto the field.

>run on
You head onto the field.

field
You find yourself standing on the field of play at your own 30 yard line. For the moment you are the center of attention. The crowd looms all around you, largely silent as they wait for you to signal your kick.

You can see the special teams unit, some officials and the opposition here.

The  kickoff unit waits for you to give the signal.

>l north
It's sidelines all the way along.

Your teammates wait impatiently for your signal.

>l east
Over on the opposition sidelines you can see a kind of mirror view of your own team. Except they all hate you and want you to lose.

The play clock has almost run out. You really must give the signal immediately.

>l west
It's your sidelines. You can see assorted coaches and teammates over there, milling around and watching the game.

Having waited for too long for you to kick, the coach is forced to call a timeout to avoid a penalty. His face is silently furious. He shouts from the sidelines about your perhaps short-lived role on the team. He suggests that you give the signal and get on with it.

* * *

>run on field
You can't see any such thing.

>run on
You run onto the field!

On the Field
You're standing on the field.

The rest of the kicking team waits for you to give the signal.

>signal
You raise your arm to signal you're about to kickoff and the kickoff team gets ready to charge down the field.

Your teammates wait for you to kick the ball.

>kick the ball
You sprint forward and swing your foot into the ball, launching it into high and far into the air toward the opposition's endzone… and swinand swing your foot into the ball, launching it into high and far into the air towar

>z
Time passes.

>z
Time passes.

>z
Time passes.

Q1, 15:00 : 1 & 0 @ 30 (1)
Home 0 - 0 Away 
Offence TOs: 3 - Defence TOs: 3 
PC: player kickoff -> PR: player kickoff -> FPR: touchback 
GYG: 0 -> NYG: 0 -> GYR: 0 -> NYR: 0 
KD: 76 -> GYR: 0 -> NYR: 0 

kickoff - kickedYour perception of time returns to normal.

The ball lands 76 yards downfield, bounding through the endzone for a touchback. 

The coach signals for you to come off the field. 

Clock is: stopped

>z
Time passes.

Your teammates all run off the field after the kick.

>z
Time passes.

The coach shouts at you to get off the field and come back over to the sidelines.

>z
Time passes.

The coach rages and gestures at you to get off the field.

>z
Time passes.

The coach is forced to call a timeout thanks to you just standing around. He doesn't look all that pleased with you. 

Two of your teammates drag you off the field between them on the coach's instructions. He spends several precious seconds of his time yelling in your face about the need to get off the field in a timely fashion.

On the Sidelines
You're standing on the sidelines.

>z
Time passes.

Q1, 14:51 : 1 & 10 @ 20 (-1)
Home 0 - 0 Away 
Offence TOs: 3 - Defence TOs: 2 
PC: run -> PR: loss -> FPR: loss 
GYG: -1 -> NYG: -1 -> GYR: 0 -> NYR: 0 
KD: 76 -> GYR: 0 -> NYR: 0 

kickoff - off the field
Clock is: running

>run on the field
You can't see any such thing.

>get on the field
Now is not a good time.

Q1, 14:18 : 2 & 11 @ 19 (-1)
Home 0 - 0 Away 
Offence TOs: 3 - Defence TOs: 2 
PC: pass -> PR: short gain -> FPR: short gain 
GYG: 6 -> NYG: 6 -> GYR: 0 -> NYR: 0 
KD: 76 -> GYR: 0 -> NYR: 0 

kickoff - off the field
Clock is: running

>z
Time passes.

Q1, 13:47 : 3 & 5 @ 25 (-1)
Home 0 - 0 Away 
Offence TOs: 3 - Defence TOs: 2 
PC: run -> PR: short gain -> FPR: short gain 
GYG: 3 -> NYG: 3 -> GYR: 0 -> NYR: 0 
KD: 76 -> GYR: 0 -> NYR: 0 

kickoff - off the field
Clock is: running

>z
Time passes.

Q1, 13:18 : 4 & 2 @ 28 (-1)
Home 0 - 0 Away 
Offence TOs: 3 - Defence TOs: 2 
PC: punt -> PR: punt -> FPR: punt 
GYG: 0 -> NYG: 0 -> GYR: 0 -> NYR: 0 
KD: 59 -> GYR: 0 -> NYR: 0 

kickoff - off the field
Clock is: stopped

>z
Time passes.

Q1, 13:06 : 1 & 10 @ 13 (1)
Home 0 - 0 Away 
Offence TOs: 2 - Defence TOs: 3 
PC: run -> PR: loss -> FPR: loss 
GYG: -2 -> NYG: -2 -> GYR: 0 -> NYR: 0 
KD: 59 -> GYR: 0 -> NYR: 0 

kickoff - off the field
Clock is: running

>z
Time passes.

Q1, 12:46 : 2 & 12 @ 11 (1)
Home 0 - 0 Away 
Offence TOs: 2 - Defence TOs: 3 
PC: pass -> PR: medium gain -> FPR: medium gain 
GYG: 9 -> NYG: 9 -> GYR: 0 -> NYR: 0 
KD: 59 -> GYR: 0 -> NYR: 0 

kickoff - off the field
Clock is: running

>z
Time passes.

Q1, 12:23 : 3 & 3 @ 20 (1)
Home 0 - 0 Away 
Offence TOs: 2 - Defence TOs: 3 
PC: pass -> PR: no gain -> FPR: no gain 
GYG: 0 -> NYG: 0 -> GYR: 0 -> NYR: 0 
KD: 59 -> GYR: 0 -> NYR: 0 

kickoff - off the field
Clock is: running

>z
Time passes.

Q1, 11:48 : 4 & 3 @ 20 (1)
Home 0 - 0 Away 
Offence TOs: 2 - Defence TOs: 3 
PC: punt -> PR: punt -> FPR: punt 
GYG: 0 -> NYG: 0 -> GYR: 0 -> NYR: 0 
KD: 47 -> GYR: 0 -> NYR: 0 

kickoff - off the field
Clock is: stopped

>z
Time passes.

Q1, 11:38 : 1 & 10 @ 33 (-1)
Home 0 - 0 Away 
Offence TOs: 3 - Defence TOs: 2 
PC: pass -> PR: big gain -> FPR: first down 
GYG: 55 -> NYG: 55 -> GYR: 0 -> NYR: 0 
KD: 47 -> GYR: 0 -> NYR: 0 

kickoff - off the field
Clock is: running

The crowd murmurs moodily.

>z
Time passes.

Q1, 11:01 : 1 & 10 @ 88 (-1)
Home 0 - 0 Away 
Offence TOs: 3 - Defence TOs: 2 
PC: pass -> PR: sack -> FPR: sack 
GYG: -4 -> NYG: -4 -> GYR: 0 -> NYR: 0 
KD: 47 -> GYR: 0 -> NYR: 0 

kickoff - off the field
Clock is: running

The crowd cheers.

>z
Time passes.

Q1, 10:29 : 2 & 14 @ 84 (-1)
Home 0 - 0 Away 
Offence TOs: 3 - Defence TOs: 2 
PC: pass -> PR: short gain -> FPR: short gain 
GYG: 4 -> NYG: 4 -> GYR: 0 -> NYR: 0 
KD: 47 -> GYR: 0 -> NYR: 0 

kickoff - off the field
Clock is: running

>z
Time passes.

Q1, 9:49 : 3 & 10 @ 88 (-1)
Home 0 - 0 Away 
Offence TOs: 3 - Defence TOs: 2 
PC: pass -> PR: incompletion -> FPR: incompletion 
GYG: 0 -> NYG: 0 -> GYR: 0 -> NYR: 0 
KD: 47 -> GYR: 0 -> NYR: 0 

kickoff - off the field
Clock is: stopped

>z
Time passes.

Q1, 9:42 : 4 & 10 @ 88 (-1)
Home 0 - 3 Away 
Offence TOs: 3 - Defence TOs: 2 
PC: field goal -> PR: field goal -> FPR: made field goal 
GYG: 0 -> NYG: 0 -> GYR: 0 -> NYR: 0 
KD: 29 -> GYR: 0 -> NYR: 0 

kickoff - off the field
Clock is: stopped

The crowd simmers.

>z
Time passes.

Q1, 9:37 : 1 & 0 @ 30 (-1)
Home 0 - 3 Away 
Offence TOs: 3 - Defence TOs: 2 
PC: kickoff -> PR: kickoff -> FPR: kickoff return 
GYG: 0 -> NYG: 0 -> GYR: 14 -> NYR: 14 
KD: 61 -> GYR: 14 -> NYR: 14 

kickoff - off the field
Clock is: stopped

>z
Time passes.

Q1, 9:27 : 1 & 10 @ 23 (1)
Home 0 - 3 Away 
Offence TOs: 2 - Defence TOs: 3 
PC: run -> PR: short gain -> FPR: short gain 
GYG: 4 -> NYG: 4 -> GYR: 14 -> NYR: 14 
KD: 61 -> GYR: 14 -> NYR: 14 

kickoff - off the field
Clock is: running

>z
Time passes.

Q1, 8:52 : 2 & 6 @ 27 (1)
Home 0 - 3 Away 
Offence TOs: 2 - Defence TOs: 3 
PC: run -> PR: short gain -> FPR: short gain 
GYG: 4 -> NYG: 4 -> GYR: 14 -> NYR: 14 
KD: 61 -> GYR: 14 -> NYR: 14 

kickoff - off the field
Clock is: running

>z
Time passes.

Q1, 8:28 : 3 & 2 @ 31 (1)
Home 0 - 3 Away 
Offence TOs: 2 - Defence TOs: 3 
PC: run -> PR: loss -> FPR: loss 
GYG: -1 -> NYG: -1 -> GYR: 14 -> NYR: 14 
KD: 61 -> GYR: 14 -> NYR: 14 

kickoff - off the field
Clock is: running

>z
Time passes.

Q1, 7:54 : 4 & 3 @ 30 (1)
Home 0 - 3 Away 
Offence TOs: 2 - Defence TOs: 3 
PC: punt -> PR: punt -> FPR: punt 
GYG: 0 -> NYG: 0 -> GYR: 0 -> NYR: 0 
KD: 69 -> GYR: 0 -> NYR: 0 

kickoff - off the field
Clock is: stopped

>z
Time passes.

Q1, 7:42 : 1 & 10 @ 1 (-1)
Home 0 - 3 Away 
Offence TOs: 3 - Defence TOs: 2 
PC: pass -> PR: incompletion -> FPR: incompletion 
GYG: 0 -> NYG: 0 -> GYR: 0 -> NYR: 0 
KD: 69 -> GYR: 0 -> NYR: 0 

kickoff - off the field
Clock is: stopped

>z
Time passes.

Q1, 7:36 : 2 & 10 @ 1 (-1)
Home 0 - 3 Away 
Offence TOs: 3 - Defence TOs: 2 
PC: pass -> PR: incompletion -> FPR: incompletion 
GYG: 0 -> NYG: 0 -> GYR: 0 -> NYR: 0 
KD: 69 -> GYR: 0 -> NYR: 0 

kickoff - off the field
Clock is: stopped

>z
Time passes.

Q1, 7:31 : 3 & 10 @ 1 (-1)
Home 0 - 3 Away 
Offence TOs: 3 - Defence TOs: 2 
PC: run -> PR: medium gain -> FPR: medium gain 
GYG: 9 -> NYG: 9 -> GYR: 0 -> NYR: 0 
KD: 69 -> GYR: 0 -> NYR: 0 

kickoff - off the field
Clock is: running

>z
Time passes.

Q1, 7:03 : 4 & 1 @ 10 (-1)
Home 0 - 3 Away 
Offence TOs: 3 - Defence TOs: 2 
PC: punt -> PR: punt -> FPR: punt 
GYG: 0 -> NYG: 0 -> GYR: 0 -> NYR: 0 
KD: 64 -> GYR: 0 -> NYR: 0 

kickoff - off the field
Clock is: stopped

>z
Time passes.

Q1, 6:51 : 1 & 10 @ 26 (1)
Home 0 - 3 Away 
Offence TOs: 2 - Defence TOs: 3 
PC: pass -> PR: big gain -> FPR: first down 
GYG: 55 -> NYG: 55 -> GYR: 0 -> NYR: 0 
KD: 64 -> GYR: 0 -> NYR: 0 

kickoff - off the field
Clock is: running

The crowd roars with excitement.

>z
Time passes.

Q1, 6:21 : 1 & 10 @ 81 (1)
Home 0 - 3 Away 
Offence TOs: 2 - Defence TOs: 3 
PC: run -> PR: no gain -> FPR: fumble 
GYG: 0 -> NYG: 0 -> GYR: 0 -> NYR: 0 
KD: 64 -> GYR: 0 -> NYR: 0 

kickoff - off the field
Clock is: stopped

The crowd groans in unison.

>z
Time passes.

Q1, 6:11 : 1 & 10 @ 19 (-1)
Home 0 - 3 Away 
Offence TOs: 3 - Defence TOs: 2 
PC: pass -> PR: medium gain -> FPR: first down 
GYG: 10 -> NYG: 10 -> GYR: 0 -> NYR: 0 
KD: 64 -> GYR: 0 -> NYR: 0 

kickoff - off the field
Clock is: running

>z
Time passes.

Q1, 5:40 : 1 & 10 @ 29 (-1)
Home 0 - 3 Away 
Offence TOs: 3 - Defence TOs: 2 
PC: pass -> PR: incompletion -> FPR: incompletion 
GYG: 0 -> NYG: 0 -> GYR: 0 -> NYR: 0 
KD: 64 -> GYR: 0 -> NYR: 0 

kickoff - off the field
Clock is: stopped

>z
Time passes.

Q1, 5:32 : 2 & 10 @ 29 (-1)
Home 0 - 3 Away 
Offence TOs: 3 - Defence TOs: 2 
PC: pass -> PR: big gain -> FPR: first down 
GYG: 62 -> NYG: 62 -> GYR: 0 -> NYR: 0 
KD: 64 -> GYR: 0 -> NYR: 0 

kickoff - off the field
Clock is: running

The crowd murmurs moodily.

>z
Time passes.

Q1, 4:55 : 1 & 9 @ 91 (-1)
Home 0 - 3 Away 
Offence TOs: 3 - Defence TOs: 2 
PC: pass -> PR: incompletion -> FPR: incompletion 
GYG: 0 -> NYG: 0 -> GYR: 0 -> NYR: 0 
KD: 64 -> GYR: 0 -> NYR: 0 

kickoff - off the field
Clock is: stopped

>z
Time passes.

Q1, 4:48 : 2 & 9 @ 91 (-1)
Home 0 - 3 Away 
Offence TOs: 3 - Defence TOs: 2 
PC: run -> PR: short gain -> FPR: short gain 
GYG: 1 -> NYG: 1 -> GYR: 0 -> NYR: 0 
KD: 64 -> GYR: 0 -> NYR: 0 

kickoff - off the field
Clock is: running

>z
Time passes.

Q1, 4:22 : 3 & 8 @ 92 (-1)
Home 0 - 3 Away 
Offence TOs: 3 - Defence TOs: 2 
PC: run -> PR: short gain -> FPR: short gain 
GYG: 1 -> NYG: 1 -> GYR: 0 -> NYR: 0 
KD: 64 -> GYR: 0 -> NYR: 0 

kickoff - off the field
Clock is: running

>z
Time passes.

Q1, 3:56 : 4 & 7 @ 93 (-1)
Home 0 - 6 Away 
Offence TOs: 3 - Defence TOs: 2 
PC: field goal -> PR: field goal -> FPR: made field goal 
GYG: 0 -> NYG: 0 -> GYR: 0 -> NYR: 0 
KD: 24 -> GYR: 0 -> NYR: 0 

kickoff - off the field
Clock is: stopped

The crowd simmers.

>z
Time passes.

Q1, 3:50 : 1 & 0 @ 30 (-1)
Home 0 - 6 Away 
Offence TOs: 3 - Defence TOs: 2 
PC: kickoff -> PR: kickoff -> FPR: kickoff return 
GYG: 0 -> NYG: 0 -> GYR: 21 -> NYR: 21 
KD: 62 -> GYR: 21 -> NYR: 21 

kickoff - off the field
Clock is: stopped

>z
Time passes.

Q1, 3:41 : 1 & 10 @ 29 (1)
Home 0 - 6 Away 
Offence TOs: 2 - Defence TOs: 3 
PC: run -> PR: short gain -> FPR: short gain 
GYG: 4 -> NYG: 4 -> GYR: 21 -> NYR: 21 
KD: 62 -> GYR: 21 -> NYR: 21 

kickoff - off the field
Clock is: running

>z
Time passes.

Q1, 3:14 : 2 & 6 @ 33 (1)
Home 0 - 6 Away 
Offence TOs: 2 - Defence TOs: 3 
PC: run -> PR: short gain -> FPR: short gain 
GYG: 3 -> NYG: 3 -> GYR: 21 -> NYR: 21 
KD: 62 -> GYR: 21 -> NYR: 21 

kickoff - off the field
Clock is: running

>z
Time passes.

Q1, 2:39 : 3 & 3 @ 36 (1)
Home 0 - 6 Away 
Offence TOs: 2 - Defence TOs: 3 
PC: run -> PR: short gain -> FPR: short gain 
GYG: 1 -> NYG: 1 -> GYR: 21 -> NYR: 21 
KD: 62 -> GYR: 21 -> NYR: 21 

kickoff - off the field
Clock is: running

>z
Time passes.

Q1, 2:08 : 4 & 2 @ 37 (1)
Home 0 - 6 Away 
Offence TOs: 2 - Defence TOs: 3 
PC: punt -> PR: punt -> FPR: punt 
GYG: 0 -> NYG: 0 -> GYR: 0 -> NYR: 0 
KD: 30 -> GYR: 0 -> NYR: 0 

kickoff - off the field
Clock is: stopped

>z
Time passes.

Q1, 1:56 : 1 & 10 @ 33 (-1)
Home 0 - 6 Away 
Offence TOs: 3 - Defence TOs: 2 
PC: run -> PR: no gain -> FPR: no gain 
GYG: 0 -> NYG: 0 -> GYR: 0 -> NYR: 0 
KD: 30 -> GYR: 0 -> NYR: 0 

kickoff - off the field
Clock is: running

>z
Time passes.

Q1, 1:20 : 2 & 10 @ 33 (-1)
Home 0 - 6 Away 
Offence TOs: 3 - Defence TOs: 2 
PC: run -> PR: short gain -> FPR: short gain 
GYG: 1 -> NYG: 1 -> GYR: 0 -> NYR: 0 
KD: 30 -> GYR: 0 -> NYR: 0 

kickoff - off the field
Clock is: running

>z
Time passes.

Q1, 0:53 : 3 & 9 @ 34 (-1)
Home 0 - 6 Away 
Offence TOs: 3 - Defence TOs: 2 
PC: pass -> PR: incompletion -> FPR: incompletion 
GYG: 0 -> NYG: 0 -> GYR: 0 -> NYR: 0 
KD: 30 -> GYR: 0 -> NYR: 0 

kickoff - off the field
Clock is: stopped

>z
Time passes.

Q1, 0:47 : 4 & 9 @ 34 (-1)
Home 0 - 6 Away 
Offence TOs: 3 - Defence TOs: 2 
PC: punt -> PR: punt -> FPR: punt 
GYG: 0 -> NYG: 0 -> GYR: 0 -> NYR: 0 
KD: 44 -> GYR: 0 -> NYR: 0 

kickoff - off the field
Clock is: stopped

>z
Time passes.

Q1, 0:37 : 1 & 10 @ 22 (1)
Home 0 - 6 Away 
Offence TOs: 2 - Defence TOs: 3 
PC: pass -> PR: incompletion -> FPR: incompletion 
GYG: 0 -> NYG: 0 -> GYR: 0 -> NYR: 0 
KD: 44 -> GYR: 0 -> NYR: 0 

kickoff - off the field
Clock is: stopped

>z
Time passes.

Q1, 0:32 : 2 & 10 @ 22 (1)
Home 0 - 6 Away 
Offence TOs: 2 - Defence TOs: 3 
PC: pass -> PR: short gain -> FPR: short gain 
GYG: 5 -> NYG: 5 -> GYR: 0 -> NYR: 0 
KD: 44 -> GYR: 0 -> NYR: 0 

kickoff - off the field
Clock is: end of quarter

The referee blows his whistle to signal the end of the quarter.

>z
Time passes.

Q1, 0:00 : 3 & 5 @ 27 (1)
Home 0 - 6 Away 
Offence TOs: 2 - Defence TOs: 3 
PC: start next quarter -> PR: start next quarter -> FPR: start next quarter 
GYG: 0 -> NYG: 0 -> GYR: 0 -> NYR: 0 
KD: 44 -> GYR: 0 -> NYR: 0 

kickoff - off the field
Clock is: start of quarter

>z
Time passes.

Q2, 15:00 : 3 & 5 @ 27 (1)
Home 0 - 6 Away 
Offence TOs: 2 - Defence TOs: 3 
PC: pass -> PR: incompletion -> FPR: false start 
GYG: 0 -> NYG: 0 -> GYR: 0 -> NYR: 0 
KD: 44 -> GYR: 0 -> NYR: 0 

kickoff - off the field
Clock is: stopped

You hear the referee's voice announce a penalty.

>z
Time passes.

Q2, 15:00 : 3 & 10 @ 22 (1)
Home 0 - 6 Away 
Offence TOs: 2 - Defence TOs: 3 
PC: run -> PR: medium gain -> FPR: false start 
GYG: 18 -> NYG: 18 -> GYR: 0 -> NYR: 0 
KD: 44 -> GYR: 0 -> NYR: 0 

kickoff - off the field
Clock is: stopped

You hear the referee's voice announce a penalty.

>z
Time passes.

Q2, 15:00 : 3 & 15 @ 17 (1)
Home 0 - 6 Away 
Offence TOs: 2 - Defence TOs: 3 
PC: pass -> PR: big gain -> FPR: first down 
GYG: 51 -> NYG: 51 -> GYR: 0 -> NYR: 0 
KD: 44 -> GYR: 0 -> NYR: 0 

kickoff - off the field
Clock is: running

The crowd roars with excitement.

>z
Time passes.

Q2, 14:35 : 1 & 10 @ 68 (1)
Home 0 - 6 Away 
Offence TOs: 2 - Defence TOs: 3 
PC: pass -> PR: medium gain -> FPR: first down 
GYG: 11 -> NYG: 11 -> GYR: 0 -> NYR: 0 
KD: 44 -> GYR: 0 -> NYR: 0 

kickoff - off the field
Clock is: running

The crowd applauds the play on the field.

>z
Time passes.

Q2, 14:04 : 1 & 10 @ 79 (1)
Home 0 - 6 Away 
Offence TOs: 2 - Defence TOs: 3 
PC: pass -> PR: short gain -> FPR: interception 
GYG: 6 -> NYG: 6 -> GYR: 15 -> NYR: 15 
KD: 44 -> GYR: 15 -> NYR: 15 

kickoff - off the field
Clock is: stopped

The crowd groans in unison.

>z
Time passes.

Q2, 13:55 : 1 & 10 @ 30 (-1)
Home 0 - 6 Away 
Offence TOs: 3 - Defence TOs: 2 
PC: pass -> PR: medium gain -> FPR: first down 
GYG: 18 -> NYG: 18 -> GYR: 15 -> NYR: 15 
KD: 44 -> GYR: 15 -> NYR: 15 

kickoff - off the field
Clock is: running

>z
Time passes.

Q2, 13:34 : 1 & 10 @ 48 (-1)
Home 0 - 12 Away 
Offence TOs: 3 - Defence TOs: 2 
PC: run -> PR: big gain -> FPR: touchdown 
GYG: 77 -> NYG: 52 -> GYR: 15 -> NYR: 15 
KD: 44 -> GYR: 15 -> NYR: 15 

kickoff - off the field
Clock is: stopped

The crowd sits in deflated silence.

>z
Time passes.

Q2, 13:28 : 1 & 2 @ 98 (-1)
Home 0 - 13 Away 
Offence TOs: 3 - Defence TOs: 2 
PC: extra point -> PR: extra point -> FPR: made extra point 
GYG: 0 -> NYG: 0 -> GYR: 15 -> NYR: 15 
KD: 44 -> GYR: 15 -> NYR: 15 

kickoff - off the field
Clock is: stopped

>z
Time passes.

Q2, 13:28 : 1 & 0 @ 30 (-1)
Home 0 - 13 Away 
Offence TOs: 3 - Defence TOs: 2 
PC: kickoff -> PR: kickoff -> FPR: kickoff return 
GYG: 0 -> NYG: 0 -> GYR: 14 -> NYR: 14 
KD: 68 -> GYR: 14 -> NYR: 14 

kickoff - off the field
Clock is: stopped

>z
Time passes.

Q2, 13:17 : 1 & 10 @ 16 (1)
Home 0 - 13 Away 
Offence TOs: 2 - Defence TOs: 3 
PC: run -> PR: short gain -> FPR: short gain 
GYG: 3 -> NYG: 3 -> GYR: 14 -> NYR: 14 
KD: 68 -> GYR: 14 -> NYR: 14 

kickoff - off the field
Clock is: running

>z
Time passes.

Q2, 12:35 : 2 & 7 @ 19 (1)
Home 0 - 13 Away 
Offence TOs: 2 - Defence TOs: 3 
PC: pass -> PR: incompletion -> FPR: incompletion 
GYG: 0 -> NYG: 0 -> GYR: 14 -> NYR: 14 
KD: 68 -> GYR: 14 -> NYR: 14 

kickoff - off the field
Clock is: stopped

>z
Time passes.

Q2, 12:29 : 3 & 7 @ 19 (1)
Home 0 - 13 Away 
Offence TOs: 2 - Defence TOs: 3 
PC: run -> PR: big gain -> FPR: first down 
GYG: 46 -> NYG: 46 -> GYR: 14 -> NYR: 14 
KD: 68 -> GYR: 14 -> NYR: 14 

kickoff - off the field
Clock is: running

The crowd roars with excitement.

>z
Time passes.

Q2, 12:04 : 1 & 10 @ 65 (1)
Home 0 - 13 Away 
Offence TOs: 2 - Defence TOs: 3 
PC: pass -> PR: loss -> FPR: loss 
GYG: -2 -> NYG: -2 -> GYR: 14 -> NYR: 14 
KD: 68 -> GYR: 14 -> NYR: 14 

kickoff - off the field
Clock is: running

>z
Time passes.

Q2, 11:32 : 2 & 12 @ 63 (1)
Home 0 - 13 Away 
Offence TOs: 2 - Defence TOs: 3 
PC: pass -> PR: incompletion -> FPR: incompletion 
GYG: 0 -> NYG: 0 -> GYR: 14 -> NYR: 14 
KD: 68 -> GYR: 14 -> NYR: 14 

kickoff - off the field
Clock is: stopped

>z
Time passes.

Q2, 11:26 : 3 & 12 @ 63 (1)
Home 0 - 13 Away 
Offence TOs: 2 - Defence TOs: 3 
PC: run -> PR: medium gain -> FPR: medium gain 
GYG: 9 -> NYG: 9 -> GYR: 14 -> NYR: 14 
KD: 68 -> GYR: 14 -> NYR: 14 

kickoff - off the field
Clock is: running

>z
Time passes.

The coach calls for the field goal unit to go and kick a field goal.

>z
Time passes.

The coach notices you're still on the sidelines and tells you to get on the field.

>z
Time passes.

The coach shouts at you to get on the field.

>z
Time passes.

The coach yells that you better run on immediately.

>run on
You run onto the field!

On the Field
You're standing on the field.

The rest of the kicking team waits for you to give the signal.

>z
Time passes.

Your teammates watch for your signal.

>z
Time passes.

The play clock has almost run out. You really need to give the signal.

>z
Time passes.

Having watched you stand motionless until the play clock is about to run out, the coach is forced to call a timeout. His face looks grim. 

The coach drags you off the field and yells about the basic requirement that a kicker kick the ball. He suggests that you get on the field and do your job. 

On the Sidelines
You're standing on the sidelines.

>z
Time passes.

The coach notices you're still on the sidelines and tells you to get on the field.

>get on the field
You run onto the field!

On the Field
You're standing on the field.

The rest of the kicking team waits for you to give the signal.

>z
Time passes.

Your teammates watch for your signal.

* * *

>z
Time passes.

The play clock has almost run out. You really need to give the signal.

>z
Time passes.

Having watched you stand motionless until the play clock is about to run out, the coach is forced to call a timeout. His face looks grim. 

Looks like you've tempted fate one too many times…⋅

    *** You got fired. You scored 0 points in 81 turns. ***

Would you like to RESTART, RESTORE a saved game, QUIT or UNDO the last command?

* * *

>make the tackle
Tackling someone right now would be incredibly impolite.

Q1, 15:00 : 1 & 0 @ 30 (1)
Home 0 - 0 Away 
Offence TOs: 3 - Defence TOs: 3 
PC: kickoff -> PR: kickoff -> FPR: kickoff return 
GYG: 0 -> NYG: 0 -> GYR: 18 -> NYR: 18 
KD: 66 -> GYR: 18 -> NYR: 18 

Clock is: stopped
The kickoff unit runs off the field.

The defense runs onto the field.

>sit on
What do you want to sit on?

>the bench
You find an empty spot and sit down.

A player comes over and informs you you're sitting in his spot. You get up, and he walks off.

Q1, 14:48 : 1 & 10 @ 22 (-1)
Home 0 - 0 Away 
Offence TOs: 3 - Defence TOs: 3 
PC: run -> PR: gain -> FPR: gain 
GYG: 1 -> NYG: 1 -> GYR: 18 -> NYR: 18 
KD: 66 -> GYR: 18 -> NYR: 18 

Clock is: running

* * *

>talk to table
Q1, 15:00 : 1 & 0 @ 30 (1)
Home 0 - 0 Away 
Offence TOs: 3 - Defence TOs: 3 
PC: kickoff -> PR: kickoff -> FPR: kickoff return 
GYG: 0 -> NYG: 0 -> GYR: 23 -> NYR: 23 
KD: 58 -> GYR: 23 -> NYR: 23 

Clock is: stopped
The kickoff unit runs off the field.

The defense runs onto the field.

>talk to quarterback
You try to think of some to say to the quarterback, but he seems busy.

Q1, 14:51 : 1 & 10 @ 35 (-1)
Home 0 - 0 Away 
Offence TOs: 3 - Defence TOs: 3 
PC: pass -> PR: incompletion -> FPR: incompletion 
GYG: 0 -> NYG: 0 -> GYR: 23 -> NYR: 23 
KD: 58 -> GYR: 23 -> NYR: 23 

Clock is: stopped

>talk to myself
Hi there.

Q1, 14:46 : 2 & 10 @ 35 (-1)
Home 0 - 0 Away 
Offence TOs: 3 - Defence TOs: 3 
PC: pass -> PR: gain -> FPR: first down 
GYG: 37 -> NYG: 37 -> GYR: 23 -> NYR: 23 
KD: 58 -> GYR: 23 -> NYR: 23 

Clock is: running

>talk to ball
Q1, 14:00 : 1 & 10 @ 72 (-1)
Home 0 - 0 Away 
Offence TOs: 3 - Defence TOs: 3 
PC: run -> PR: loss -> FPR: loss 
GYG: -4 -> NYG: -4 -> GYR: 23 -> NYR: 23 
KD: 58 -> GYR: 23 -> NYR: 23 

Clock is: running

* * *

>read myself
You've never been very good at reading people.

The coach orders you to run onto the field.

>read quarterback
You've never been very good at reading people.

The coach grinds his teeth and tells you to run onto the field.

>take ball
Leave the kicking ball alone.

The coach screams with a red face that you have to run on right now.

>take head coach
Hey! Hands off!

Your head coach uses a timeout because you didn't even run onto the field to kick. He looks extraordinarily unimpressed. He whacks you on the shoulder and yells at you to run onto the field.

>take screen
Leave the screens alone.

The coach calls you over and tells you to run onto the field.

>sigh
You sigh.

The coach screams at you to run onto the field.

>jog
You jog furiously on the spot for a couple of seconds, then stop. It's tiring.

The coach yells that you better run on immediately.

>stretch
You ostentaiously perform a hamstring stretch, looking around to see if anyone's watching.

The coach is forced to call a time out because you just stood on the sidelines instead of kicking. He looks extremely displeased. He grabs you by the jersey and orders you to run onto the field.

* * *

>kick ball
You swing your leg and launch the practice ball into the net. You look around to see if anyone saw how nicely you did that. Nope. You replace the ball into the holder for another kick.

Your coach tells you to run onto the field.

>kick
(the kicking ball)
You step into the kick and hammer the practice ball into the back of the net. It's good! Well, it would have been. You set the ball up again.

Your coach screams at you to run onto the field.

>run on
You head onto the field.

The Field
You find yourself standing on the field of play at your own 30 yard line. It's one of those rare times when all eyes are turned on you. The crowd looms all around you, largely silent as they wait for you to signal your kick. To the west you can see your home sidelines and to the east is the opposition sidelines. The Jumbotron looms above it all.

You can see the special teams unit, some officials and the opposition here.

The rest of the coverage team wait for you to give the signal.

>kick
(the game ball)
Now is not really a good time for that.

Your teammates wait impatiently for your signal.

>x game
Which do you mean, the fieldgame or the game ball?

* * *

>run onto field
You run onto the field!

On the Field
You're standing on the field.

The rest of the kicking team waits for you to give the signal.

>signal
You raise your arm to signal you're about to kickoff and the kickoff team gets ready to charge down the field.

Your teammates wait for you to kick the ball.

>kick the ball
You sprint forward and swing your foot into the ball, launching it into high and far into the air toward the opposition's endzone… and swing d swing your foot into the ball, launching it into high and far into the air towar

>z
Time passes.

>z
Time passes.

Your perception of time returns to normal.

The ball lands 76 yards downfield, bouncing through the endzone for a touchback. 

The coach signals for you to run off the field.

>run off the field
You run off the field.

On the Sidelines
You're standing on the sidelines.

* * *

>read head coach
You've never been very good at reading people…
The coach orders you to run onto the field.

>read cup
You start reading the paper cup, then wonder about how much that makes sense, then stop.

The coach grinds his teeth and tells you to run onto the field.

* * *

>run on the field
You can't see any such thing.

>get on the field
You run onto the field!

On the Field
You're standing on the field.

The rest of the kicking team waits for you to give the signal.

>signal
You raise your arm to signal you're about to kickoff and the kickoff team gets ready to charge down the field.

Your teammates wait for you to kick the ball.

>z
Time passes.

Your teammates look a little confused about why you don't just kick the ball.

>z
Time passes.

The play clock has almost run out, you really should kick the ball.

>z
Time passes.

Having watched you stand motionless until the play clock is about to run out, the coach is forced to call a timeout. His face looks grim. 

The coach drags you off the field and yells about the basic requirement that a kicker kick the ball. He suggests that you get on the field and do your job. 

On the Sidelines
You're standing on the sidelines.

>get on the field
You run onto the field!

On the Field
You're standing on the field.

The rest of the kicking team waits for you to give the signal.

* * *

>signal
You raise your arm to signal you're about to kickoff and the kickoff team gets ready to charge down the field.

Your teammates wait for you to kick the ball.

>kick the ball
You sprint forward and swing your foot into the ball, launching it into high and far into the air toward the opposition's endzone… and swin⩏nd swing your foot into the ball, launching it into high and far into the air toward the opposit敨獳瀭湧

>z
Time passes.

>z
Time passes.

Q1, 15:00 : 1 & 0 @ 30 (1)
Home 0 - 0 Away 
Offence TOs: 2 - Defence TOs: 3 
PC: kickoff -> PR: kickoff -> FPR: kickoff return 
GYG: 0 -> NYG: 0 -> GYR: 15 -> NYR: 15 
KD: 62 -> GYR: 15 -> NYR: 15 

Clock is: stopped

>z
Time passes.

Your teammates all run off the field after the kick.

* * *

>x bench
It's very hard to understand why the benches have to be quite so unpleasant to sit on, but they are.

Your coach tells you to run onto the field.

>x bench
It's very hard to understand why the benches have to be quite so unpleasant to sit on, but they are.

Your coach seeths as he tells you to run onto the field.

>x jumbotron
On the Jumbotron there's an image of a kicker standing around on the sidelines. What a jerk.

Your coach screams with a red face that you have to run on without delay.

>l
The Sidelines
Ah yes, the sidelines. The place where you spend almost all of your time. The ground is a little muddy and the benches are almost vindictively uncomfortable, but it is what it is. There's a bunch of equipment around and as always it's crowded with teammates, coaches, and assorted others. To the west you can see the part of the stadium seating nearest you, and to the east you can see the field. The Jumbotron looms above it all.

You can see the offensive unit, the defensive unit, the holder, the punter, the head coach, the special teams coach, some assistant coaches, a film crew, some cheerleaders and an equipment manager here.

Your head coach has to burn a timeout because you didn't even run onto the field to kick. He looks extremely displeased. He suggests that perhaps this time you would do everyone a favour and run onto the field.